11111111111
10000100001
10110101101
11110111101
10000000001
10111111101
10000000101
10111110101
10100000101
101E11101S1
11111111111