11111111111
10100010001
10101010101
10101010101
10101010101
10101010101
10101010101
10101010101
10101010101
1E0010001S1
11111111111